0 0 0 0 0 0 0 0
0 9 8 2 6 5 0 0
0 2 11 10 2 6 5 0
0 8 12 2 2 6 5 0
0 3 3 2 2 6 5 0
0 0 3 2 2 6 5 0
0 0 3 3 7 1 5 0
0 0 0 0 0 0 0 0
